0,0,0,0,1,2,3,2,3,0,1,0,1,0,1,2,3,2,3,3
0,0,0,1,2,3,1,2,0,1,2,3,0,0,1,2,3,1,2,3
0,0,1,0,1,2,3,3,0,1,2,3,1,0,1,2,3,3,3,3
0,1,0,1,2,3,2,3,0,1,2,3,0,1,2,3,0,1,2,3
0,1,0,1,0,1,2,3,3,1,2,3,0,1,2,3,1,0,1,2
1,2,0,0,1,2,3,3,2,3,2,3,1,2,3,0,1,0,1,2
1,2,3,0,1,41,41,41,41,41,41,41,41,41,3,1,2,0,1,2
2,3,0,1,2,41,41,41,41,41,41,41,41,41,1,2,3,0,1,2
2,3,0,0,0,41,41,41,41,41,41,41,41,41,3,2,0,1,0,1
3,1,0,1,2,41,41,41,41,41,41,41,41,41,2,0,1,2,0,1
3,2,3,0,0,41,41,41,41,41,41,41,41,41,2,0,1,2,0,1
0,1,0,0,1,2,0,1,2,41,1,2,3,2,0,1,2,3,0,1
0,1,0,1,2,3,0,1,2,0,1,2,3,2,0,0,1,2,0,1
0,0,1,2,3,0,1,2,0,1,2,3,1,2,0,1,2,3,0,1
0,1,2,3,1,0,1,2,0,1,2,3,1,2,0,1,2,3,0,1
1,2,3,0,0,0,1,0,1,2,3,0,1,0,1,2,3,1,0,1
2,3,2,3,0,0,0,1,2,3,1,0,1,0,1,2,3,0,1,2
3,1,2,3,0,0,1,2,0,1,2,0,0,1,2,3,0,0,1,2
0,1,2,3,2,0,0,0,1,2,3,0,0,1,2,3,0,1,2,3
0,1,2,3,0,0,1,2,3,0,1,0,0,1,2,0,1,2,3,3
